+++++++++++++++++++++++++
+-----------------------+
+--+++++++++++++++++++--+
+--+--------------------+
+--+-+++++++++++++++-+--+
+--+-----------------+--+
+--+--------++++++++++--+
+--+-----------------+--+
+--+-------++-++++++----+
+--+++++++++++++++++++--+
+-----------------------+
+--+++++++++++++++++++--+
+-----------------------+
+--+++++++++++++++++++--+
+-----------------------+
+--+++++++++++++++++++--+
+-----------------------+
+--+++++++++++++++++++--+
+-----------------------+
+--+++++++++++++++++++--+
+-----------------------+
+-----------------------+
+-----------------------+
+-----------------------+
+++++++++++++++++++++++++
